{
  "width": 25,
  "height": 25,
  "layout": [
    ["W", "W", "W", "W", "W", "W", "W", "W", "W", "W", "W", "W", "W", "W", "W", "W", "W", "W", "W", "W", "W", "W", "W", "W", "W"],
    ["W", ".", ".", ".", ".", ".", ".", ".", ".", ".", ".", ".", ".", ".", ".", ".", ".", ".", ".", ".", ".", ".", ".", ".", "W"],
    ["W", ".", "W", "W", "W", "W", "W", "W", "W", "W", "W", "W", "W", "W", "W", "W", "W", "W", "W", "W", "W", "W", "W", ".", "W"],
    ["W", ".", "W", ".", ".", ".", ".", ".", ".", ".", ".", ".", ".", ".", ".", ".", ".", ".", ".", ".", ".", ".", "W", ".", "W"],
    ["W", ".", "W", ".", "W", "W", "W", "W", "W", "W", "W", "W", "W", "W", "W", "W", "W", "W", "W", "W", "W", ".", "W", ".", "W"],
    ["W", ".", "W", ".", "W", ".", ".", ".", ".", ".", ".", ".", ".", ".", ".", ".", ".", ".", ".", ".", "W", ".", "W", ".", "W"],
    ["W", ".", "W", ".", "W", ".", "W", "W", "W", "W", "W", "W", "W", "W", "W", "W", "W", "W", "W", ".", "W", ".", "W", ".", "W"],
    ["W", ".", "W", ".", "W", ".", "W", ".", ".", ".", ".", ".", ".", ".", ".", ".", ".", ".", "W", ".", "W", ".", "W", ".", "W"],
    ["W", ".", "W", ".", "W", ".", "W", ".", "W", "W", "W", "W", "W", "W", "W", "W", "W", ".", "W", ".", "W", ".", "W", ".", "W"],
    ["W", ".", "W", ".", "W", ".", "W", ".", "W", ".", ".", ".", ".", ".", ".", ".", "W", ".", "W", ".", "W", ".", "W", ".", "W"],
    ["W", ".", "W", ".", "W", ".", "W", ".", "W", ".", "W", "W", "W", "W", "W", ".", "W", ".", "W", ".", "W", ".", "W", ".", "W"],
    ["W", ".", "W", ".", "W", ".", "W", ".", "W", ".", "W", "B", "B", "B", "W", ".", "W", ".", "W", ".", "W", ".", "W", ".", "W"],
    ["W", ".", "W", ".", "W", ".", "W", ".", "W", ".", "W", "B", "B", "B", "W", ".", "W", ".", "W", ".", "W", ".", "W", ".", "W"],
    ["W", ".", "W", ".", "W", ".", "W", ".", "W", ".", "W", "B", "B", "B", "W", ".", "W", ".", "W", ".", "W", ".", "W", ".", "W"],
    ["W", ".", "W", ".", "W", ".", "W", ".", "W", ".", "W", "W", "D", "W", "W", ".", "W", ".", "W", ".", "W", ".", "W", ".", "W"],
    ["W", ".", "W", ".", "W", ".", "W", ".", "W", ".", ".", ".", ".", ".", ".", ".", "W", ".", "W", ".", "W", ".", "W", ".", "W"],
    ["W", ".", "W", ".", "W", ".", "W", ".", "W", "W", "W", "W", "W", "W", "W", "W", "W", ".", "W", ".", "W", ".", "W", ".", "W"],
    ["W", ".", "W", ".", "W", ".", "W", ".", ".", ".", ".", ".", ".", ".", ".", ".", ".", ".", "W", ".", "W", ".", "W", ".", "W"],
    ["W", ".", "W", ".", "W", ".", "W", "W", "W", "W", "W", "W", "W", "W", "W", "W", "W", "W", "W", ".", "W", ".", "W", ".", "W"],
    ["W", ".", "W", ".", "W", ".", ".", ".", ".", ".", ".", ".", ".", ".", ".", ".", ".", ".", ".", ".", "W", ".", "W", ".", "W"],
    ["W", ".", "W", ".", "W", "W", "W", "W", "W", "W", "W", "W", "W", "W", "W", "W", "W", "W", "W", "W", "W", ".", "W", ".", "W"],
    ["W", ".", "W", ".", ".", ".", ".", ".", ".", ".", ".", ".", ".", ".", ".", ".", ".", ".", ".", ".", ".", ".", "W", ".", "W"],
    ["W", ".", "W", "W", "W", "W", "W", "W", "W", "W", "W", "W", "W", "W", "W", "W", "W", "W", "W", "W", "W", "W", "W", ".", "W"],
    ["W", ".", ".", ".", ".", ".", ".", ".", ".", ".", ".", ".", ".", ".", ".", ".", ".", ".", ".", ".", ".", ".", ".", ".", "W"],
    ["W", "W", "W", "W", "W", "W", "W", "W", "W", "W", "W", "W", "W", "W", "W", "W", "W", "W", "W", "W", "W", "W", "W", "W", "W"]
  ],
  "objects": {
    "D": {"type": "door", "locked": true, "keyType": "gold"},
    "B": {"type": "enemy", "enemyType": "boss"}
  },
  "playerStart": {"x": 1, "y": 1}
}
