{
  "width": 15,
  "height": 15,
  "layout": [
    ["W", "W", "W", "W", "W", "W", "W", "W", "W", "W", "W", "W", "W", "W", "W"],
    ["W", ".", ".", ".", ".", ".", ".", ".", ".", ".", ".", ".", ".", ".", "W"],
    ["W", ".", "W", "W", "W", ".", "W", "W", "W", "W", ".", "W", "W", ".", "W"],
    ["W", ".", "W", ".", ".", ".", ".", ".", ".", "W", ".", ".", "W", ".", "W"],
    ["W", ".", "W", ".", "W", "W", "W", "W", ".", "W", "W", ".", "W", ".", "W"],
    ["W", ".", ".", ".", "W", "C", ".", "W", ".", ".", ".", ".", ".", ".", "W"],
    ["W", ".", "W", "W", "W", ".", ".", "W", ".", "W", ".", "W", "W", "W", "W"],
    ["W", ".", ".", ".", "D", ".", "S", ".", ".", "W", ".", ".", ".", ".", "W"],
    ["W", "W", "W", "W", "W", "W", "W", "W", "W", "W", ".", "W", "W", ".", "W"],
    ["W", ".", ".", ".", ".", ".", ".", ".", ".", "W", ".", "W", ".", ".", "W"],
    ["W", ".", "W", "W", "W", "W", ".", "W", ".", "W", ".", "W", ".", "W", "W"],
    ["W", ".", ".", ".", ".", "W", ".", "W", ".", ".", ".", "W", ".", ".", "W"],
    ["W", "W", "W", "W", ".", "W", ".", "W", "W", "W", "W", "W", "W", ".", "W"],
    ["W", "G", ".", ".", ".", ".", ".", ".", ".", ".", ".", ".", ".", "P", "W"],
    ["W", "W", "W", "W", "W", "W", "W", "W", "W", "W", "W", "W", "W", "W", "W"]
  ],
  "objects": {
    "D": {"type": "door", "locked": true, "keyType": "gold"},
    "S": {"type": "enemy", "enemyType": "skeleton"},
    "G": {"type": "enemy", "enemyType": "goblin"},
    "C": {"type": "chest", "contains": "key_gold"},
    "P": {"type": "chest", "contains": "health_potion"}
  },
  "playerStart": {"x": 1, "y": 1}
}
