{
  "width": 20,
  "height": 20,
  "layout": [
    ["W", "W", "W", "W", "W", "W", "W", "W", "W", "W", "W", "W", "W", "W", "W", "W", "W", "W", "W", "W"],
    ["W", ".", ".", ".", ".", ".", ".", ".", ".", ".", "W", ".", ".", ".", ".", ".", ".", ".", ".", "W"],
    ["W", ".", "W", "W", "W", "W", ".", "W", "W", ".", "W", ".", "W", "W", "W", ".", "W", "W", ".", "W"],
    ["W", ".", "W", ".", ".", ".", ".", ".", "W", ".", "W", ".", ".", ".", "W", ".", "W", ".", ".", "W"],
    ["W", ".", "W", ".", "W", "W", "W", ".", "W", ".", "W", "W", "W", ".", "W", ".", "W", ".", "W", "W"],
    ["W", ".", ".", ".", "W", "G", "W", ".", ".", ".", ".", ".", ".", ".", "W", ".", ".", ".", ".", "W"],
    ["W", "W", "W", "W", "W", ".", "W", "W", "W", "W", "W", "W", "W", "W", "W", ".", "W", "W", ".", "W"],
    ["W", ".", ".", ".", "W", ".", ".", ".", ".", ".", ".", ".", ".", ".", "D", ".", ".", "W", ".", "W"],
    ["W", ".", "W", ".", "W", "W", "W", "W", "W", "W", "W", "W", "W", "W", "W", "W", ".", "W", ".", "W"],
    ["W", ".", "W", ".", ".", ".", ".", ".", ".", ".", ".", ".", ".", ".", ".", ".", ".", "W", ".", "W"],
    ["W", ".", "W", "W", "W", "W", "W", "W", "W", "W", "W", "W", "W", "W", "W", "W", "W", "W", ".", "W"],
    ["W", ".", ".", ".", ".", ".", ".", ".", ".", ".", ".", ".", ".", ".", ".", ".", ".", ".", ".", "W"],
    ["W", ".", "W", "W", "W", "W", "W", "W", "W", "W", ".", "W", "W", "W", "W", "W", "W", "W", "W", "W"],
    ["W", ".", ".", ".", ".", ".", ".", ".", ".", "W", ".", "W", ".", ".", ".", ".", ".", ".", ".", "W"],
    ["W", "W", "W", "W", "W", "W", "W", "W", ".", "W", ".", "W", ".", "W", "W", "W", "W", "W", ".", "W"],
    ["W", "P", ".", ".", ".", ".", ".", "W", ".", "W", ".", "W", ".", "W", "Z", ".", ".", ".", ".", "W"],
    ["W", ".", "W", "W", "W", "W", ".", "W", ".", "W", ".", "W", ".", "W", "W", "W", "W", "W", "W", "W"],
    ["W", ".", "W", "C", ".", "W", ".", ".", ".", "W", ".", ".", ".", ".", ".", ".", ".", ".", "S", "W"],
    ["W", ".", "W", "W", "W", "W", "W", "W", "W", "W", "W", "W", "W", "W", "W", "W", "W", "W", ".", "W"],
    ["W", "W", "W", "W", "W", "W", "W", "W", "W", "W", "W", "W", "W", "W", "W", "W", "W", "W", "W", "W"]
  ],
  "objects": {
    "D": {"type": "door", "locked": true, "keyType": "silver"},
    "S": {"type": "enemy", "enemyType": "skeleton"},
    "G": {"type": "enemy", "enemyType": "goblin"},
    "Z": {"type": "enemy", "enemyType": "wizard"},
    "C": {"type": "chest", "contains": "key_silver"},
    "P": {"type": "chest", "contains": "health_potion"},
    "secret_4_17": {"type": "secret_door"}
  },
  "playerStart": {"x": 1, "y": 1}
}
